66A666q6666hhh66i6j666869666q6f66hhh669666i6j666A66hhhh666666A66
600L60006E60006000006000006w00006GxG60006000006E0060000600060006
AwT0W0G0000060606660J0666066966060E06060006L6000M000NO00060b0C0A
600L60006L60i000006060006000006066W66X66J66666600E60000606i60006
66A666f6666060NoN0i000N0666060600000006000b000666666666606066A66
60000000600000NEN060NON06000J060Mn0nM06066j66066G000G60000060006
i06960606066600000000000606j6000nM0Mn060600000000000C606JJ6606L6
J0606060j0006660MnM0nMn0000000000000000000606i66G000G60000060666
i000600060h06L60M00000n0666066E00E6606860660006966066606a6060006
i066606060000000n0MnM0M000600666666006060060600006b606060006660J
6000006000N06E60M0EnL0n0600000000000660666606606060600000M00000i
6J606660NON06660MnMnMnM00066f60006q666000800060600000nMn0nMn0666
j00000000000006000000000h06L0000000L666ij60666060696000000000006
i06i606660666060606L666000600000000060000000660006E66606q606f606
6006006E000E60006066600060600000000060600Mn000060006G000G600600a
66066660E0E0606660000060600000NGN00000600nM0606660660E0E06666066
600600600x00600000660660600000GOG0000060000060600008E0G0E8006006
f066606E0G0E606660000660600000NGN00000600nM0600066060E0E0606CM0H
60060066666680000066006060600000000060600Mn0006660066iJj66006006
6600066000006F6A6q6A60006060000000006060000060006066L00006600066
6a606600MnM000000E6000h0006L0000000L6000606666600006660h00660666
60606L0No0006060000060006666q60006f66660606000006600000h00060006
A000000nN006606606H66060000600000006000000J00666A66960000666660J
66i6j60NNM00000000000096i6000666660006i6606i00000000600606E0060J
600000000N0660660686006E00060000000600006006j6q60HH0666600000006
606J66660o0000000q0006666f666q6X6F666JJ66600600000H0000006L0E606
600000E606ii6066060H06MnMnMnMnM0MnMnMnMnM6066060600000666666660i
6606E00600000006000006M00M00Gn000MC00M00n60000606068666000600006
66066066606666666A6b66nM0n0MnM0n0MnM0n0nM666966060000060N0006666
6006000600060006000006M00n00000M00000n00Ma0000Y066J66060006060E6
A0660h060h060h06C6b666n0MnM0Mn0n0Mn0MnM0n606H6666000606606666066
60G6000600060006660by6M00En00M000n00ME00n6Z600060066600006000006
60000h000h000h00060606n0MnMn0MnMnM0nMnM0M60006066000666i6606j60q
60G6000600060006066i06M00n00000000000M00n6066A0060N006E000060006
A0660h060h060h06060006Mn000MnMn0MnMn000Mn6000660i0NN06660666060f
60C60006000600060006E6nMnMnMEnM0nMEnMnMnM66600606000060000600006
6666666666666666666666n0000M000G000M0000M60000000060660666606J66
60EGC6000000060E000006M0nM0n0Mn0Mn0M0nM0nA0606666060000000000006
A0666q06i606000HH0hh0An0Mn0M0nM0nM0n0Mn0M60000006000No06i6066066
6000060000000600000E06M00M000ME0En000n00n66jj66066000N000j0E60A6
66i6000666666660606j66Mn0nMn0n0z0M0nMn0Mn60000600006000606066066
6000060E6m0E60006000Lqn00Ln00ME0En00nL00M6060666jJ66060i00060006
i06666666606666066f666M0nMn0MnM0nMn0MnM0n608006000060j06j6000606
600000060G0G06006E0006n0MEM000n0M000nEn0M6E660006600060000060006
66iJ6606E0G0E606666606M00000n00000M00000n6A600600000666066066066
6000Lj060E0E060000EA06MnMnMnMnMnMnMnMnMnM6060666EE6006L006060006
i0666606G000G6066666066666666666666666666606000666600000E6060666
6060006666W6666000060006G0L0G60L6G0L0G6000000600000060606A000006
F00060006E0G6066660006060E0E060660E0E0606606660E00E060000606660f
6066A6606606606000060006660666006660666006000600000000660006L006
J00000000000000060696000000006600000006606060006j6i660060E666066
600660M0n06i6066600000660666000060666060060006000000660606600006
6E0060000000006G60686006006006J66006000066060669606006000000060F
60E0606i6066000000060066600000000060060660060000006600006E066i06
666000JEj00666E0E60006606606i606066066000066606i600000606600000f
6000606066000660666066A0060000060060000Mn00060j06066066000066066
6066600060060000000000606660606660000600006000600060000006060006
606E66066066066L660660006000006600660666006606660666b6i6J600060q
600000060000006A6000660660660660066006E0066000000000000000060006
666060666066606E606060006060006066606660660006660666066i66066066
h000J000006000000060006000006000600000006006006E0E600600E0006006
h06i6j606G60666066606660666060666060hhh000666060w060660606666609
h00000006L60000000006G000L600000006000006000006E0E600006000006G6
66A666q6666hhh66i6j666869666q6f66666669666i6j666A66hhhh6666A6666