1111111111
1d00110S01
11101E0011
1000101111
10T01011t1
1000100001
10P0111101
1D111T0001
1000000P01
1111111111