1111111111111111
10T010E000000001
10d0101110101101
11D1100C10001001
1000111110111011
1E00100000L10001
1000001110110101
100E100010110001
1000111000000101
1101101000000101
1100100011111101
1110110110000001
1000000011V11101
1011111010001101
100v1E0010S01001
1111111111111111