1121112124213121
2LTL30E000000002
10v0101210101104
11V1100C10001003
1000111110434011
2E00200000L10002
1000004210110101
200E100010110002
1000111000000104
1203101000000103
1100100011111104
1140110110000002
1000000011V11101
1011211040001102
100v1E0020002001
1121111111511121