899999999998
900000000008
a00000000T08
900000000008
900000000008
600000000008
700000000008
800000000008
8S0000000008
888888888888