1111111111111111
10S0100000110001
1000101110000101
11V1101111111101
1001001E000E1001
10110110E0E01011
1000001E000E1001
1110101110111101
1000100000000001
1011110110110101
1000000100010001
101111110T011101
101000111111v101
1010101100010101
1000100001000001
1111111111111111