888888888888
800000000008
800000000T08
800000000008
800000JkJ008
800000000008
800aAbBcC008
800000000008
8S0000000008
888888888888