698a66666i6jI666
60T0668E00000006
60w06E6660606606
66W6600C6000f006
600A606660666066
6066600b00L6000J
60E0006660660606
6000600060660006
6E0E66606066060H
660660600000060i
66006000666A6606
6660660660000006
6000000066X66606
i066H66060006606
600xhG0060S06E0h
66666666666666I6