66i6866H6666666666jij6A6666666H6
j0000E606000666q660C06z600G0660i
J0C0G000006E06000600060000000W06
60000E6066A66i0T0j0E06060E00660q
66696660000006000600060666666H06
600000006666066066E0E60E66600006
i0MnM0666A6600000700060066A06J66
J0nwn0f0000666606f6Y6F6066600006
6000006686000000000000000b00660i
666066600006060i6A666i9J66066F06
600060006JJ60600060006x60006060I
i06J60606000060606E606060h06060j
600060666066660600060E0600000H0j
6660606i00000006666Jjii60606060i
h0006006060666000600060006060006
h06666060606660M000M000666066666
h00006000600E000060006660000000a
66606660666666606660660006066066
6000006060000600006000066606E0E6
i0E0E0606E00060660606JH6E0060006
600000H00000E60000b000066JI6E0E6
8L000066666066i0J66696060E060006
60000000L6606000000006000006E0E6
J00G000G00Z0006j6606060i0E060006
60000000L660600000060006j6j66X66
66ij6iJ667600060666F66666f66M0M6
6000000000a666600600000000060006
90NNON0660600066060LE000EL06n0n6
600EN000606060000600000000060006
6660o00060606Ji6066666066666M0n6
Ay00N060600066660000000000060006
666i6A6A66666666686i6i66JJ666m66