11111111111111111111111111111111
10S01000000000000100000001000001
100010101111V111010111110101E101
11X111101100000100010T0100011101
10000010010E0E010101000101000001
101110100100E00100011d1101110111
101000000111011110111D11010001L1
1E101010010000010000000001010101
11100000110111010111101101000001
10001110110w1E010100000000010101
10E01000111111110101101101000101
100010E010E00E010101100E010100E1
101110001E0000E10000001111011111
1000101110E00E01110110011001v001
11100011111001110001110000111101
1000L000100000010101E10110001101
10111110100000010100010110100001
10001L10000110000111L10000101011
11011000000110000001110111101001
1E001101100000010100000110001101
100E1100100000010110110000100001
1E0010001111111100001E0110111111
11011011100000000100000E000011E1
1L001010001101101100110101100001
100000001000E0001000110101111111
100L1011101101101101100001000011
11011000000000100000001011011W11
1E0E11111011101111V111100001E0E1
1101100000001011E000E11111010E01
10001010111010Dd00C00dD01101ExE1
10100010E1L01011E000E11000010E01
11111111111111111111111111111111