66m666i66jJ666ii6666HH6i6666A666
60006000000000000000000006000006
6000606066i6W6j66066966E060OGN06
66Z66qi06MnM0nMn6060T060000NNo0j
h0000060qn0E0E0Mq0600060E6000006
h06660606M00E00n608606900A660696
h0600000fnMn0MnMf0660660060007L8
hE60h0h06M00000n6000000006060606
66600000Fn0N0N0Mf0MnM0MM06000006
i00066606M0xOE0n60000000000h060j
j0E060006MnMnMnM600Mn0nn0M000606
i00060E0i6A66A66i00nM00E0n0600E6
60666000jE0000E6000000nMnM066J66
6000606i60E00E066606600No006w006
6660006j666006660006660000666606
6000L000J000000a0606E6066000660i
J06q6f60600000060i00060660600006
60006L60000Mn00006J6L60000J0N066
66066000000nM0000006q6066i60O006
6E00660660000006060000066000NN0f
600E660C600000060660660000600006
6E00600G66A66A6600006E0hh06i6666
66066066600000000600000E0000i6E6
iL00606000Mn0nM06600Mn0606600006
J00000006000E0006000nM06066jqJ66
j00L606660Mn0MM06606600006000066
66066000000000000000006066066X66
6E0E66a66066606666y666600006E0E6
6606600000006066G000E66666060G06
800060606960606a00C00q606606EyE6
H0600060E6L06066E0z0G66000060G06
6q66i6666666666666A6666hhhh66A66