1111111111111111111111111111111111111111111111111111111111111111
100L11000110001000001000001w00001EGG10001000001E0E10000100010001
1T00dD0E0dD0101011101011101111101EGG1110001L100000001100010V0C01
100L110001101000001010001000001011911D111111111E0E10000101110001
1111111111101011101000101110101000000010001000111111111101011111
100000001000001E10101110100010101101101011111011E0E0E10000010001
1011101010111000000000001011100011011010100000dD0E0EC101111101L1
101010101000111011101110000000000000000000101111E0E0E10000010111
1000100010101L101000001011101111011101110110001111d1110111010001
10111010100000001011101000100000001001010010100001D1010100011101
1000001000101E10100100101000100010001101111011010101000001000001
1110111011101110111111100011110001111100010001010000011101110111
100000000000001000001000101L000000001111110111010111000000000001
10111011101110101010111000100000000010000000110001E1110111011101
1001001E000E1000101110001010000000001011011000010001E000E1001001
11011110E0E01011100000101000003E300000110110101110110E0E01111011
100100100v00100000110110100000E3E0000011000010100001E0E0E1001001
1011101E0E0E1011100001101000003E300000110110100011010E0E01011101
1001001111111000001100101010000000001011011000111001111111001001
1100011000001111111110001100000000011000000000000000000001100011
1110110000000000000000000100000000L10000000000000000000000110111
1010000000000000000000000111100011110000000000000000000000000001
1000000000000000000000000000000000000000000000000000000000000001
1000000000000000000000000000111110000000000000000000000000000001
1000000000000000000000000000000000000000000000000000000000000001
1000000000000000000011111111110111111111100000000000000000000001
100000000000000000001222222222W222222222100000000000000000000001
1000000000000000000012E0200E20002E0020E2100000000000000000000001
1000000000000000000012202022202022202022100000000000000000000001
1000000000000000000012002000002000002002100000000000000000000001
1000000000000000000012022202202022022202100000000000000000000001
100000000000000000001200E20020002002E002100000000000000000000001
1000000000000000000012022220222220222202100000000000000000000001
1000000000000000000012002000000000002002100000000000000000000001
1000000000000000000012200022220222200022100000000000000000000001
100000000000000000001222222E22022E222222100000000000000000000001
100000000000000000001200002000E000200002100000000000000000000001
1000000000000000000012022020220220202202100000000000000000000001
1000000000000000000012022020220220202202100000000000000000000001
10000000000000000000120020002E0E20002002100000000000000000000001
1000000000000000000012202220200020222022100000000000000000000001
100000000000000000001200E2002E0E2002E002100000000000000000000001
1000000000000000000012022202220222022202100000000000000000000001
100000000000000000001202E20002020002E202100000000000000000000001
1000000000000000000012000002000002000002100000000000000000000001
1000000000000000000012222222222222222222100000000000000000000001
1000000000000000000011111111111111111111100000000000000000000001
1000000000000000000000000000000000000000000000000000000000000001
1000000000000000000000000000000000000000000000000000000000000001
1000000000000000000000000000000000000000000000000000000000000001
1000000000000000000000000000000000000000000000000000000000000001
1000000000000000000000000000000000000000000000000000000000000001
1000000000000000000000000000000000000000000000000000000000000001
1000000000000000000000000000000000000000000000000000000000000001
1000000000000000000000000000000000000000000000000000000000000001
1000000000000000000000000000000000000000000000000000000000000001
1000000000000000000000000000000000000000000000000000000000000001
1000000000000000000000000000000000000000000000000000000000000001
1000000000000000000000000000000000000000000000000000000000000001
1000000000000000000000000000000000000000000000000000000000000001
1000000000000000000000000000000000000000000000000000000000000001
1000000000000000000000000000000000000000000000000000000000000001
1000000000000000000000000000000000000000000000000000000000000001
1111111111111111111111111111111111111111111111111111111111111111