66A666q6666hhh66i6j666869666q6f66hhh669666i6j666A66hhhh666666A66
600L60006E60006000006000006w00006GxG60006000006E0E60000600060006
AwT0W0G0000060606660J066606696606GEG6060006L60000000NO00060b0C0A
600L60006E60i000006060006000006066W66X66J666666E0E60000606i60006
66A666f6666060NoN0i000N0666060600000006000b000666666666606066A66
60000000600000NEN060NON06000J060Mn0nM06066j66066G0E0G60000060006
i06960606066600000000000606j6000nM0Mn060600000000000C606JJ6606L6
J0606060j0006660MnM0nMn0000000000000000000606i66G0E0G60000060666
i000600060h06L60M00000n0666066E00E6606860660006966066606a6060006
i066606060000000n0MnM0M000600666666006060060600006b606060006660J
6000006000N06E60M00n00n0600000000000660666606606060600000M00000i
6J606660NON06660MnMnMnM00066f60006q666000600060600000nMn0nMn0666
j00000000000006000000000h06L000000006611110111010111000000000001
i0111011101110101010111000600000000060000000110001E1110111011101
1001001E000E1000101110001060000000006011011000010001E000E1001001
11011110E0E0101110000010100000NGN00000110110101110110E0E01111011
100100100v00100000110110100000GOG0000011000010100001E0E0E1001001
1011101E0E0E101110000110100000NGN00000110110100011010E0E01011101
1001001111111000001100101060000000006011011000111001111111001001
1100011000001111111110001060000000001000000000000000000001100011
11101100000000000000000000600000000L6000000000000000000000110111
1010000000000000000000000666q60006f66000000000000000000000000001
1000000000000000000000000000000000000000000000000000000000000001
1000000000000000000000000000111110000000000000000000000000000001
1000000000000000000000000000000000000000000000000000000000000001
1000000000000000000066666666660666666666600000000000000000000001
100000000000000000006MnMnMnMnMWMnMnMnMnM600000000000000000000001
100000000000000000006ME0M00En000ME00M0En600000000000000000000001
1000000000000000000012202022202022202022100000000000000000000001
1000000000000000000012002000002000002002100000000000000000000001
1000000000000000000012022202202022022202100000000000000000000001
100000000000000000001200E20020002002E002100000000000000000000001
1000000000000000000012022220222220222202100000000000000000000001
1000000000000000000012002000000000002002100000000000000000000001
1000000000000000000012200022220222200022100000000000000000000001
100000000000000000001222222E22022E222222100000000000000000000001
100000000000000000001200002000E000200002100000000000000000000001
1000000000000000000012022020220220202202100000000000000000000001
1000000000000000000012022020220220202202100000000000000000000001
10000000000000000000120020002E0E20002002100000000000000000000001
1000000000000000000012202220200020222022100000000000000000000001
100000000000000000001200E2002E0E2002E002100000000000000000000001
1000000000000000000012022202220222022202100000000000000000000001
100000000000000000001202E20002020002E202100000000000000000000001
1000000000000000000012000002000002000002100000000000000000000001
1000000000000000000012222222222222222222100000000000000000000001
1000000000000000000011111111111111111111100000000000000000000001
1000000000000000000000000000000000000000000000000000000000000001
1000000000000000000000000000000000000000000000000000000000000001
1000000000000000000000000000000000000000000000000000000000000001
1000000000000000000000000000000000000000000000000000000000000001
1000000000000000000000000000000000000000000000000000000000000001
1000000000000000000000000000000000000000000000000000000000000001
1000000000000000000000000000000000000000000000000000000000000001
1000000000000000000000000000000000000000000000000000000000000001
1000000000000000000000000000000000000000000000000000000000000001
1000000000000000000000000000000000000000000000000000000000000001
1000000000000000000000000000000000000000000000000000000000000001
1000000000000000000000000000000000000000000000000000000000000001
1000000000000000000000000000000000000000000000000000000000000001
1000000000000000000000000000000000000000000000000000000000000001
1000000000000000000000000000000000000000000000000000000000000001
1000000000000000000000000000000000000000000000000000000000000001
1111111111111111111111111111111111111111111111111111111111111111