11111111111111111111111111111111
1T000EEC010000000000000000000001
100d0EEC010000000000000000000001
100L0EEC01E000000000000000000001
1D111111110000000000000000000001
100LLLLLL00000000000000000000001
10S00vV0000000000000000000000001
10000wW0000000000000000000000001
10000xX0000000000000000000000001
10G00yY0000000000000000000000001
10000zZ0000000000000000000000001
10000000000000000000000000000001
10000000000000000000000000000001
10000000000000000000000000000001
10000000000000000000000000000001
10000000000000000000000000000001
10000000000000000000000000000001
10000000000000000000000000000001
10000000000000000000000000000001
10000000000000000000000000000001
10000000000000000000000000000001
10000000000000000000000000000001
10000000000000000000000000000001
10000000000000000000000000000001
10000000000000000000000000000001
10000000000000000000000000000001
10000000000000000000000000000001
10000000000000000000000000000001
10000000000000000000000000000001
10000000000000000000000000000001
10000000000000000000000000000001
11111111111111111111111111111111