11111111111111111111111111111111
10000E1010001111110E010100E01101
10L0C000001E01CT010C01000000dD01
100C0E101111110E010E01010E001101
11111110000001000100010111111101
100000001111011011E0E10E11100001
10111010111100000100010011101111
1011101000011111011V111011100001
10000011110000000000000001001101
11101110000101011111111101011101
1000100011110100010001w100010101
101110101000010101E1010101010101
100010111011110100010E0100000101
11101011000000011111111101010101
10001001010111000100010001010001
10111101010111010001000111011111
100001000100E0000100011100000001
11101110111111101110110001011011
1000001010000100001000011101E0E1
10E0E0101E00010110101111E0010001
100000100000E100000000011111E0E1
1L00001111101110111111010E010001
10000000L1101000000001000001E0E1
100E000E0dD00011110101010E010001
10000000L11010000001000111111W11
11111111111000101111111111110001
10000000001111100100000000010001
1011110110100011010LE000EL010001
100E1000101010000100000000010001
11101000101011110111110111110P01
1v001010100011110000000000010001
11111111111111111111111111111111