11123456789111111111111111111111
1T000000000100000000000000000001
1d000000000B00000000000000000001
10000000000100000000000000000001
1D111111111100000000000000000001
1D0LELLLL00000000000000000000001
1DS00vV0000000000000000000000001
1G100wW0000000000000000000000001
10100xX0000000000000000000000001
10100yY0000000000000000000000001
10100zZ0000000000000000000000001
10100000000000000000000000000001
10000000000000000000000000000001
10000000000000000000000000000001
10000000000000000000000000000001
10000000000000000000000000000001
10000000000000000000000000000001
10000000000000000000000000000001
10000000000000000000000000000001
10000000000000000000000000000001
10000000000000000000000000000001
10000000000000000000000000000001
10000000000000000000000000000001
10000000000000000000000000000001
10000000000000000000000000000001
10000000000000000000000000000001
10000000000000000000000000000001
10000000000000000000000000000001
10000000000000000000000000000001
10000000000000000000000000000001
10000000000000000000000000000001
11111111111111111111111111111111