11111111111111111111111111111111
1T0000CC010000000000000000000001
100d00CC010000000000000000000001
100L00CC01E000000000000000000001
1D111111110000000000000000000001
100LL000000000000000000000000001
10S00vV0000000000000000000000001
10000wW0000000000000000000000001
10000xX0000000000000000000000001
10000yY0000000000000000000000001
10000zZ0000000000000000000000001
10000000000000000000000000000001
10000000000000000000000000000001
10000000000000000000000000000001
10000000000000000000000000000001
10000000000000000000000000000001
10000000000000000000000000000001
10000000000000000000000000000001
10000000000000000000000000000001
10000000000000000000000000000001
10000000000000000000000000000001
10000000000000000000000000000001
10000000000000000000000000000001
10000000000000000000000000000001
10000000000000000000000000000001
10000000000000000000000000000001
10000000000000000000000000000001
10000000000000000000000000000001
10000000000000000000000000000001
10000000000000000000000000000001
10000000000000000000000000000001
11111111111111111111111111111111