11111111111111111111111111111111
1Y0000000000000000000000000000T1
10000000000000000000000000000001
10000000000000000000000000000001
10000000000000000000000000000001
10000000000000000000000000000001
10000000000000000000000000000001
10000000000000000000000000000001
10000000000000000000000000000001
10000000000000000000000000000001
10000000000000000000000000000001
10000000000YYYYYY100000000000001
10000000000000000000000000000001
10000000000000000000000000000001
10000000000000000000000000000001
10000000000000000000000000000001
10000000000000000000000000000001
10000000000000000000000000000001
10000000000000000000000000000001
10000000000000000000000000000001
100000100000E100000000011111E0E1
1L00001111101110111111010E010001
10000000L1101000000001000001E0E1
100E000E0dD00011110101010E010001
10000000L11010000001000111111W11
11111111111000101111111111110001
10000000011111001000000000010001
1011110110100011010LE000EL010001
100E100010101000010YYYYYYYY10001
11101000101011110111110111110P01
1v001010100011110000000000010001
11111111111111111111111111111111