11111111111111111111111111111111
100000EC010000000000000000000001
100d00EC010000000000000000000001
100L00EC01E000000000000000000001
1D11111111000000000L000000000001
100LLLLLL000000LLLLLLLLLL0000001
10S00vV00000000000LL000000000001
10000wW000000000000L000000000001
10000xX0000000000000000000000001
10000yY000000000000L000000000001
10000zZ0000000T0000L000000000001
10000000000000000000000000000001
10000000000000000000000000000001
10000000000000000000000000000001
10000000000000000000000000000001
10000000000000000000000000000001
10000000000000000000000000000001
10000000000000000000000000000001
10000000000000000000000000000001
10000000000000000000000000000001
10000000000000000000000000000001
10000000000000000000000000000001
10000000000000000000000000000001
10000000000000000000000000000001
10000000000000000000000000000001
10000000000000000000000000000001
10000000000000000000000000000001
10000000000000000000000000000001
10000000000000000000000000000001
10000000000000000000000000000001
10000000000000000000000000000001
11111111111111111111111111111111