11123211111111111111111111111111
1T00000C01E000000000000000000001
1d00000C011000000000000000000001
100L000C01E000000000000000000001
1D11B111110000000000000000000001
1D0LELLLL00000000000000000000001
1DS00vV0000000000000000000000001
1G100wW0000000000000000000000001
10100xX0000000000000000000000001
10100yY0000000000000000000000001
10100zZ0000000000000000000000001
10100000000000000000000000000001
10000000000000000000000000000001
10000000000000000000000000000001
10000000000000000000000000000001
10000000000000000000000000000001
10000000000000000000000000000001
10000000000000000000000000000001
10000000000000000000000000000001
10000000000000000000000000000001
10000000000000000000000000000001
10000000000000000000000000000001
10000000000000000000000000000001
10000000000000000000000000000001
10000000000000000000000000000001
10000000000000000000000000000001
10000000000000000000000000000001
10000000000000000000000000000001
10000000000000000000000000000001
10000000000000000000000000000001
10000000000000000000000000000001
11111111111111111111111111111111