111111111111
100000000001
100000000001
100000000001
100011110001
100011110001
100011110001
100011110001
100000000001
100000000001
100000000001
111111111111
